{
  "width": 24,
  "height": 20,
  "tilewidth": 32,
  "tileheight": 32,
  "layers": [
    {
      "name": "bgtiles",
      "width": 24,
      "height": 20,
      "data": [
        272, 272, 272, 272, 272, 272, 272, 272, 272, 272, 272, 272, 272, 272, 272, 272, 272, 272, 272, 272, 272, 272, 272, 272,
        272, 272, 272, 272, 272, 272, 272, 272, 272, 272, 272, 272, 272, 272, 272, 272, 272, 272, 272, 272, 272, 272, 272, 272,
        272, 272, 272, 272, 272, 272, 272, 272, 272, 272, 272, 272, 272, 272, 272, 272, 272, 272, 272, 272, 272, 272, 272, 272,
        272, 272, 272, 272, 272, 272, 272, 272, 272, 272, 272, 272, 272, 272, 272, 272, 272, 272, 272, 272, 272, 272, 272, 272,
        272, 272, 272, 272, 272, 272, 272, 272, 272, 272, 272, 272, 272, 272, 272, 272, 272, 272, 272, 272, 272, 272, 272, 272,
        272, 272, 272, 272, 272, 272, 272, 272, 272, 272, 272, 272, 272, 272, 272, 272, 272, 272, 272, 272, 272, 272, 272, 272,
        272, 272, 272, 272, 272, 272, 272, 272, 272, 272, 272, 272, 272, 272, 272, 272, 272, 272, 272, 272, 272, 272, 272, 272,
        272, 272, 272, 272, 272, 272, 272, 272, 272, 272, 272, 272, 272, 272, 272, 272, 272, 272, 272, 272, 272, 272, 272, 272,
        272, 272, 272, 272, 272, 272, 272, 272, 272, 272, 272, 272, 272, 272, 272, 272, 272, 272, 272, 272, 272, 272, 272, 272,
        272, 272, 272, 272, 272, 272, 272, 272, 272, 272, 272, 272, 272, 272, 272, 272, 272, 272, 272, 272, 272, 272, 272, 272,
        272, 272, 272, 272, 272, 272, 272, 272, 272, 272, 272, 272, 272, 272, 272, 272, 272, 272, 272, 272, 272, 272, 272, 272,
        272, 272, 272, 272, 272, 272, 272, 272, 272, 272, 272, 272, 272, 272, 272, 272, 272, 272, 272, 272, 272, 272, 272, 272,
        272, 272, 272, 272, 272, 272, 272, 272, 272, 272, 272, 272, 272, 272, 272, 272, 272, 272, 272, 272, 272, 272, 272, 272,
        272, 272, 272, 272, 272, 272, 272, 272, 272, 272, 272, 272, 272, 272, 272, 272, 272, 272, 272, 272, 272, 272, 272, 272,
        272, 272, 272, 272, 272, 272, 272, 272, 272, 272, 272, 272, 272, 272, 272, 272, 272, 272, 272, 272, 272, 272, 272, 272,
        272, 272, 272, 272, 272, 272, 272, 272, 272, 272, 272, 272, 272, 272, 272, 272, 272, 272, 272, 272, 272, 272, 272, 272,
        272, 272, 272, 272, 272, 272, 272, 272, 272, 272, 272, 272, 272, 272, 272, 272, 272, 272, 272, 272, 272, 272, 272, 272,
        272, 272, 272, 272, 272, 272, 272, 272, 272, 272, 272, 272, 272, 272, 272, 272, 272, 272, 272, 272, 272, 272, 272, 272,
        272, 272, 272, 272, 272, 272, 272, 272, 272, 272, 272, 272, 272, 272, 272, 272, 272, 272, 272, 272, 272, 272, 272, 272,
        272, 272, 272, 272, 272, 272, 272, 272, 272, 272, 272, 272, 272, 272, 272, 272, 272, 272, 272, 272, 272, 272, 272, 272
      ]
    },
    {
      "name": "objmap",
      "width": 24,
      "height": 20,
      "data": [
        0, 0, 0, 0, 0, 0, 0, 0, 0, 0, 0, 0, 0, 0, 0, 0, 0, 0, 0, 0, 0, 0, 0, 0,
        0, 0, 0, 0, 0, 0, 0, 0, 0, 0, 0, 0, 0, 0, 0, 0, 0, 0, 0, 0, 0, 0, 0, 0,
        0, 0, 0, 0, 0, 0, 0, 0, 0, 0, 0, 0, 0, 0, 0, 0, 0, 0, 0, 0, 0, 0, 0, 0,
        0, 0, 0, 0, 0, 0, 0, 0, 0, 0, 0, 0, 0, 0, 0, 0, 0, 0, 0, 0, 0, 0, 0, 0,
        0, 0, 0, 0, 0, 0, 0, 0, 0, 0, 0, 0, 0, 0, 0, 0, 0, 0, 0, 0, 0, 0, 0, 0,
        0, 0, 0, 0, 0, 0, 0, 0, 0, 0, 0, 0, 0, 0, 0, 0, 0, 0, 0, 0, 0, 0, 0, 0,
        0, 0, 0, 0, 0, 0, 0, 0, 0, 0, 0, 0, 0, 0, 0, 0, 0, 0, 0, 0, 0, 0, 0, 0,
        0, 0, 0, 0, 0, 0, 0, 0, 0, 0, 0, 0, 0, 0, 0, 0, 0, 0, 0, 0, 0, 0, 0, 0,
        0, 0, 0, 0, 0, 0, 0, 0, 0, 0, 0, 0, 0, 0, 0, 0, 0, 0, 0, 0, 0, 0, 0, 0,
        0, 0, 0, 0, 0, 0, 0, 0, 0, 0, 0, 0, 0, 0, 0, 0, 0, 0, 0, 0, 0, 0, 0, 0,
        0, 0, 0, 0, 0, 0, 0, 0, 0, 0, 0, 0, 0, 0, 0, 0, 0, 0, 0, 0, 0, 0, 0, 0,
        0, 0, 0, 0, 0, 0, 0, 0, 0, 0, 0, 0, 0, 0, 0, 0, 0, 0, 0, 0, 0, 0, 0, 0,
        0, 0, 0, 0, 0, 0, 0, 0, 0, 0, 0, 0, 0, 0, 0, 0, 0, 0, 0, 0, 0, 0, 0, 0,
        0, 0, 0, 0, 0, 0, 0, 0, 0, 0, 0, 0, 0, 0, 0, 0, 0, 0, 0, 0, 0, 0, 0, 0,
        0, 0, 0, 0, 0, 0, 0, 0, 0, 0, 0, 0, 0, 0, 0, 0, 0, 0, 0, 0, 0, 0, 0, 0,
        0, 0, 0, 0, 0, 0, 0, 0, 0, 0, 0, 0, 0, 0, 0, 0, 0, 0, 0, 0, 0, 0, 0, 0,
        0, 0, 0, 0, 0, 0, 0, 0, 0, 0, 0, 0, 0, 0, 0, 0, 0, 0, 0, 0, 0, 0, 0, 0,
        0, 0, 0, 0, 0, 0, 0, 0, 0, 0, 0, 0, 0, 0, 0, 0, 0, 0, 0, 0, 0, 0, 0, 0,
        0, 0, 0, 0, 0, 0, 0, 0, 0, 0, 0, 0, 0, 0, 0, 0, 0, 0, 0, 0, 0, 0, 0, 0,
        0, 0, 0, 0, 0, 0, 0, 0, 0, 0, 0, 0, 0, 0, 0, 0, 0, 0, 0, 0, 0, 0, 0, 0
      ]
    }
  ]
}
